F 220,100,0

NO      ./textures/blue_light.xpm

SO      ./textures/concrete.xpm

WE      ./textures/tech_0G.xpm

EA      ./textures/win_blue_light.xpm

C 255,255,255

            111111111111
            100000000001
            100000000001
            100000000001
            100000000001
            100000000001
            100000000001
            100000000001
            100000000001
            100000000001
            100000000001
111111111111100000000001111111111111
10000000000000000N000000000000000001
100000000000000000000000000000000001
100000000000000000000000000000000001
100000000000000000000000000000000001
100000000000000000000000000000000001
100000000000000000000000000000000001
100000000000000000000000000000000001
100000000000000000000000000000000001
100000000000000000000000000000000001
100000000000000000000000000000000001
100000000000000000000000000000000001
111111111111100000000001111111111111
            100000000001
            100000000001
            100000000001
            100000000001
            100000000001
            100000000001
            100000000001
            100000000001
            100000000001
            100000000001
            100000000001
            111111111111
