SO        ./textures/concrete.xpm

        NO    ./textures/win_blue_light.xpm

       WE       ./textures/blue_light.xpm

EA        ./textures/tech_0G.xpm

       F     2 , 47 , 56


C 51, 102, 255


111111111111111111111111
1S1000001000000000000001
101011101011110111111101
101010001010000100000001
101010111010111101111111
101010001010100101000001
101011101010100101011101
101000101010000101000101
100011101011110101111101
100010001000010100000001
111110101111010101111101
100000100000010100010001
101111111101110111111101
100110000000100100010001
111111111111111111111111